x . . a a a a a . . x
. . . . . a . . . . .
. . . . . . . . . . .
a . . . . d . . . . a
a . . . d d d . . . a
a a . d d k d d . a a
a . . . d d d . . . a
a . . . . d . . . . a
. . . . . . . . . . .
. . . . . a . . . . .
x . . a a a a a . . x